1111111111111111111111111111111111111111111111111111
10000100000000000000111111111000000011111000C0000101
11100C001111110000000C000000000000000000000011000101
100000000C00000P0011111111100011111110000011111000E1
100001110C0000000000000C0000000110000001000000000001
1111111111111111111111111111111111111111111111111111