11111111111
10000100001
11100C0P001
10000000001
100001110C1
11111111111