111111111111111111111111111111111111111111111111111111
10000100000000000000111111111000000011111000C000010111
11100C001111110000000C00000000000000000000001100010111
100000000C00000P0011111111100011111110000011111000E111
100001110C0000000000000C000000011000000100000000000111
111111111111111111111111111111111111111111111111111111